+--------+------+--------+
|deptcode|roomno|capacity|
+--------+------+--------+
|CARD    |101   |2       |
|CARD    |102   |4       |
|NEUR    |201   |1       |
+--------+------+--------+
